bbbbbbbbbb...........
b.....ggggggggggggggg
b...................r
b.....gggbbbbbbbbbb.r
b........b..........r
b....rr..b..........r
b....rr..b....gg....r
b........b....gg....r
b........b..........r
bbbbbbbbbbbbbbbbbbbbb
.....................
.....................
.....................
.....................
.....................
.....................
.....................
.....................
.....................
.....................
.....................
