rrrrrrrrrr...........
r.....ggggggggggggggr
r...................r
b....bbbbbbbbbbbbb..r
r........r..........r
r....rr..r..........r
r....rr..r....ww....r
r........r....ww....r
r........r..........r
rrrrrrrrrrrrrrrrrrrrr
.....................
.....................
.....................
.....................
.....................
.....................
.....................
.....................
.....................
.....................
.....................
