sssmsssssssssssssssss
s....sggggggggggggggs
m...................s
m....sgg.gggg.ggggg.s
mmmsss.........s....s
bbbbss..s.....tt....s
b....bs..s....tt....s
f........s....tt....s
b....b...s..........s
bbbbbsssssssss...ssss
s...................s
s...................s
s...................s
s...................s
s.......tttttt......s
s...................s
s...................s
s...................s
s...................s
s...........bb......s
sssssssssssssssssssss
