sssmsssssssssssssssss
s....s......ggggggggs
m...................s
m....sgg.gggg.ggggg.s
mmm.ss.........s....s
bbb.ss..s.....tt....s
b....bs..s....tt....s
f........s....tt....s
b....b...s..........s
bbbbbsssssssss...ssss
s...................s
s...................s
s...................s
s...................s
s.......tttttt......s
s...................s
s...................s
s...................s
s...................s
s...........bb......s
sssssssssssssssssssss
